LXXXIV: HPR
LVIII: HUQ
XXXII: YYS
XLVIII: NXT
LXXVI: GTM
XVI: FUP
XXII: MOG
LII: WXZ
LI: KMI
XXVIII: RGU
LXVIII: WLD
LXVI: HQQ
XXXVI: DZU
LIX: SFZ
LXXX: GTD
LXI: LOA
XLVII: KUC
XCV: OOI
XCII: UWR
LX: HVR
XLVI: QPG
LXVII: CQH
XLIX: HWE
XCVII: YOY
LXII: MPN
XXXIV: BDJ
LIV: OKS
XC: CCQ
LXIII: HDR
XCVIII: DKT
LXXXI: ZBE
LXIV: VAQ
XIV: MWT
XII: ZAE
XCIX: VRM
XXIV: CNX
LXX: SAU
LXXV: MZP
LVI: WAT
L: SFM
III: TSF
LXXIX: PRZ
XI: MXV
XXXI: NEB
LXV: POR
XXIX: TFS
XIX: PYL
XVII: CVN
XCIV: LXP
XXX: PRI
X: TED
VIII: TYN
LXXXVI: WQG
XXI: SAB
XLV: MNO
XLIV: XTF
I: OGP
XCVI: VEV
LXXXVIII: PWL
LXXIV: DDJ
IV: VUJ
XXV: LKN
XXXVII: YKU
XLIII: RBL
XL: UHH
LXXXIII: TOL
XXXVIII: EGM
XLII: DQH
XXXV: AQX
LV: PJT
LXXI: RWF
LXXXVII: DMI
LXIX: AVJ
VII: GGH
II: TRU
XCI: EWC
XXXIX: ERF
XX: NQL
XVIII: BPC
LXXIII: ISW
XXXIII: JRO
XV: CKI
XXVI: KFS
XLI: XDF
LXXXIX: QIL
XXVII: ZNN
LXXXII: RCY
VI: POC
XCIII: MQD
XIII: TZE
V: SPZ
LXXII: RNN
LXXVII: PRR
LIII: EWO
LXXXV: WCV
LXXVIII: ZKI
IX: XYU
LVII: RKH
XXIII: LSR
